NO textures/north_texture.xpm
SO textures/south_texture.xpm
WE textures/west_texture.xpm
EA textures/east_texture.xpm

F 18,53,25
C 153,204,255

1111111111111111  101
1000000000000001  101
1000000000000001  101
1000111111000001   1
1000100W00100001
1000111111100001
1000000000000001
1111111111111111
