NO textures/north_texture.xpm
SO textures/south_texture.xpm
WE textures/west_texture.xpm
EA textures/east_texture.xpm

F 18,53,25
C 153,204,255

111111111111
100000000001
101111110101
101000010101
1010N0010101
101011111001
100000000001
111111111111
11111 111111
1         11
1          1
111111111111
100000000001
111111111111
11         1
111111111111
